b b b b b b b b b b b b
b e b e e e e e e e b b
b e b e e e e e t e b b
b e b b e e t e e e e b
b e e b t e e e e e e b
b e e b e e e b b b e b
b e t e e e e e e e e b
b e e e h e s e e t e b
b b b b b b b b b b b b
