b b b b b b b b b b b b
b e e e e e e e e e t b
b e e e e t e e e e e b
b e e e e e e e e e e b
b b t b e b e e b e b b
b e b t b e e b t b e b
b e e e e e e e e e e b
b e e b h e s e b e e b
b b b b b b b b b b b b
